Finanslov;År;I alt;Bachelor;Kandidat;heraf: Medicin*;Tandlæge*;Dyrlæge*
R;2012;12638;7172;5466;514;90;247
R;2013;13426;7687;5739;546;102;186
R;2014;12987;7435;5552;544;97;183
R;2015;13298;7499;5799;548;98;182
R;2016;13552;7084;6468;540;98;183
B;2017;13110;7021;6089;550;100;182
F;2018;13364;6986;6378;509;90;200
BO1;2019;13251;6979;6272;509;90;200
BO2;2020;13111;6979;6132;509;90;200
BO3;2021;13103;6979;6124;509;90;200
